start=启动
stop=停止
startall=全部启动
stopall=全部停止
startweb=启动web
stopweb=停止web
startsql=启动数据库
stopsql=停止数据库
Daemon=进程守护
hide=隐藏
show=显示
Title=洛奇管理工具
OK=确定
info=提示
warnning=警告
error=错误
Question=询问
View=管理
Help=帮助
About=关于
UpdateServerSettings=更新服务端设置
AboutText=工具:$name\n版本:$vesion\n作者:$author
ServerManager=服务端管理
allSalon=全沙龙物品
SalonPirce=沙龙无限期
tool=功能
tipStopTask=不能停止任务
tipFileNotExist=文件不存在!\n{0}
tipDealDb=处理下面2个数据库\n{0}\n{1}
tipDealClientDb=处理客户端数据库\n{0}
tipDealServerDb=处理服务端数据库\n{0}
tipTaskCompleted=任务完成!
errorGameCode=游戏代码设置错误
zhtw2zhcn=台服转国服
selectZhTWPath=选择台服客户端目录
enEu2zhcn=欧服转国服
selectEnEuPath=选择欧服客户端目录
tipcloseserver=是否关闭服务端？
ServerDbSplit=分离
tipServerDbSplitFail=分离失败
ServerDbAttach=附加
TipServerDbAttachFail=附加失败
ServerDbCreate=创建
TipServerDbCreateFail=创建失败
ServerDbCompress=压缩
ErrorSqlServerNotInstall=SQLServer没有安装
ErrorSqlServerNotStart=无法启动数据库{0}
ErrorSqlServerNotConnect=无法连接数据库
TipServerStopSqlServer=是否停止数据库?
TipServerSettingOk=设置成功
TipServerSettingFail=设置失败:code={0}
TipBadGameCode=无法识别的游戏代码:{0}
ErrorNoFindSettings=没找到配置文件
ErrorSetGameCodeFail=设置游戏代码失败
TipSelectSqlBakPath=选择数据库备份bak文件的文件夹
TipServerCreateDbOK=创建{0}个数据库成功
ErrorServerCreateDbFail=创建数据库失败\n请确保数据库备份文件存在
TipServerCompressDbOK=压缩{0}个数据库成功
ErrorServerCompressDbFail=压缩数据库失败\n请确保数据库存在
ErrorProcessStop=异常结束!
TipServerAttachDbOK=附加{0}个数据库成功
ErrorServerAttachDbFail=附加数据库失败\n请确保数据库mdf存在
TipServerClearSqlLog=是否清空数据库日志？
TipServerSplitDbOK=附加{0}个数据库成功
ErrorServerSplitDbFail=附加数据库失败\n请确保数据库mdf存在
MailTitle=标题
UserName=名字
UserClass=职业
UserLevel=等级
UserList=角色列表
ItemDetail=物品详情
MailSending=发送箱
MailReceiver=收件箱
TipInit=初始化
ConnectSqlServer=连接数据库。。
TipReadText=读取翻译文本
TipReadItem=读取全物品
GroupLight=光明
GroupDark=黑暗
UnKnown=未知
UserGroup=阵营
Classes=利斯塔,菲欧娜,伊菲,卡鲁,凯,维拉,赫克,琳,艾瑞莎,赫基,蒂莉亚
MainCategory=-,首饰,时装,衣服,碎片,沙龙,技能书,活动,商品,重甲,轻甲,材料,板甲,任务,背部,尾巴,提尔硬币,武器
SubCategory=-,炼金术士盒子,炼金工具,外观,神器,时装鞋子,时装手套,时装帽子,活动礼包,时装礼包,时装裤子,时装套装,外衣,徽章,胡子,腰带,人体彩绘,鞋子,手镯,子弹,胶囊,现金物品,灭魔手套,饰品,清洁剂,碎片,耳环,肩章,结晶,技能书,眉毛,脸彩,羽毛,Gacha时装,Gacha武器,礼包,宝石,手套,头发,头盔,内衣,工具,巨盾,妆容,法力宝石,项链,时装礼包,裤子,图案,药剂,任务,稀有,背部,戒指,伤疤,卷轴,盾,技能书,觉醒石,魔法书,任务卷轴,辅助武器,尾,头衔卷轴,城镇效果,外衣,武器
ItemName=物品名字
ItemRequireLevel=需求等级
ItemMaxStack=最大叠放数量
UnLimit=不限
Category=分类
Feature=限制条件
ClassRestriction=职业限制
TipReadUsers=读取全部角色
RefeshMail=刷新邮箱
DeleteMails=删除选中邮箱
DeleteAllMails=删除全部邮箱
NoUser=没有选择角色
RefreshUser=刷新角色
AddTitle=添加头衔
AddTitles=添加全部头衔
MaxSubClass=副职业满级
MaxGroupLight=光明阵营满级
MaxGroupDark=黑暗阵营满级
ResetGroupSkill=重置阵营技能
ModUser=修改角色
ResetQuestTimes=重置副本次数